2111111113
1100000011
1000000001
1000000001
1000000001
1000000001
1100000011
3111111112