21111111131
11000000111
10000010111
10000010011
11111110011
10000011111
11000000111
31111111121
#jumppads=1,1|3,1
#iceblocks=10,0|10,2|10,3|10,4|10,5|10,6