2111111113
1100000011
1000001011
1000001001
1111111001
1000001111
1100000011
3111111112
#jumppads=1,1|3,1