111000111
001101100
000111000
000111000
001101100
111000111